177,177,177,177,177,177,177,177,177,177,177,177,177,177,177,177,177,177,177,177,177,177,177,177,177,177,177,177,177,177,177,177,177,177,177,177,177,177,177,177,177,177,177,177,177,177,177,177,177,177
177,177,177,177,177,177,177,177,177,177,177,177,177,177,177,177,177,177,177,177,177,177,177,177,177,177,177,177,177,177,177,177,177,177,177,177,177,177,177,177,177,177,177,177,177,177,177,177,177,177
177,177,9,10,10,10,11,177,9,10,10,10,11,9,10,10,11,177,9,10,10,10,11,177,177,177,177,177,177,177,177,177,177,177,177,177,177,177,177,177,177,177,177,177,177,177,177,177,177,177
177,177,25,26,26,26,27,177,25,26,26,26,27,25,26,26,27,177,25,26,26,26,27,177,177,177,177,177,177,177,177,177,177,177,177,177,177,177,177,177,177,177,177,177,177,177,177,177,177,177
177,177,25,26,26,26,27,177,25,26,26,26,27,25,26,26,27,177,25,26,26,26,27,177,177,177,177,177,177,177,177,177,177,177,177,177,177,177,177,177,177,177,177,177,177,177,177,177,177,177
177,177,25,26,26,26,27,177,25,26,26,26,27,25,26,26,27,177,25,26,26,26,27,177,177,177,177,177,177,177,177,177,177,177,177,177,177,177,177,177,177,177,177,177,177,177,177,177,177,177
177,177,25,26,26,26,27,177,25,26,26,26,27,25,26,26,27,177,25,26,26,26,27,177,177,177,177,177,177,177,177,177,177,177,177,177,177,177,177,177,177,177,177,177,177,177,177,177,177,177
177,177,25,26,26,26,27,177,25,26,26,26,27,25,26,26,27,177,25,26,26,26,27,177,177,177,177,177,177,177,177,177,177,177,177,177,177,177,177,177,177,177,177,177,177,177,177,177,177,177
177,177,41,42,42,42,43,177,41,42,42,42,43,41,42,42,43,177,41,42,42,42,43,177,177,177,177,177,177,177,177,177,177,177,177,177,177,177,177,177,177,177,177,177,177,177,177,177,177,177
6,7,7,7,7,7,7,7,7,7,7,7,7,7,7,7,7,7,7,7,7,7,7,7,7,8,177,177,177,177,177,177,177,177,177,177,177,177,177,177,177,177,177,177,177,177,177,177,177,177
22,23,23,23,23,23,23,23,23,23,23,23,23,23,23,23,23,23,23,23,23,23,23,23,23,24,177,177,177,177,177,177,177,177,177,177,177,177,177,177,177,177,177,177,177,177,177,177,177,177
38,39,39,39,39,39,39,39,39,39,39,39,39,39,39,39,39,39,39,39,39,39,39,39,39,40,177,177,177,177,177,177,177,177,177,177,177,177,177,177,177,177,177,177,177,177,177,177,177,177
177,177,177,177,177,177,177,177,177,177,177,177,177,177,177,177,177,177,177,177,177,177,177,177,177,177,177,177,177,177,177,177,177,177,177,177,177,177,177,177,177,177,177,177,177,177,177,177,177,177
177,177,177,177,177,177,177,177,177,177,177,177,177,177,177,177,177,177,177,177,177,3,4,4,4,4,4,4,4,4,4,4,4,4,4,4,4,4,4,5,177,177,177,177,177,177,177,177,177,177
177,177,177,177,177,177,177,177,177,177,177,177,177,177,177,177,177,177,177,177,177,19,20,20,20,20,20,20,20,20,20,20,20,20,20,20,20,20,20,21,177,177,177,177,177,177,177,177,177,177
177,177,177,177,177,177,177,177,177,177,177,177,177,177,177,177,177,177,177,177,177,19,20,51,36,36,36,36,36,36,36,36,36,36,36,36,36,52,20,21,177,177,177,177,177,177,177,177,177,177
177,177,177,177,177,177,177,177,177,177,177,177,177,177,177,177,177,177,177,177,177,19,20,21,177,177,177,177,177,177,177,177,177,177,177,177,177,19,20,21,177,177,177,177,177,177,177,177,177,177
177,177,177,177,177,177,177,177,177,177,177,177,177,177,177,177,177,177,177,177,177,19,20,21,177,177,177,177,177,177,177,177,177,177,177,177,177,19,20,21,177,177,177,177,177,177,177,177,177,177
1,1,1,1,1,1,1,1,1,1,1,1,1,1,1,1,1,1,1,1,2,19,20,21,177,177,177,177,177,177,177,177,177,177,177,177,177,19,20,21,177,177,177,177,177,177,177,177,177,177
17,17,17,17,17,17,17,17,17,17,17,17,17,17,17,17,17,17,17,17,18,19,20,21,177,177,177,177,177,177,177,177,177,177,177,177,177,19,20,21,177,177,177,177,177,177,177,177,177,177
33,33,33,33,33,33,33,33,33,33,33,33,33,33,33,33,33,33,33,33,34,19,20,21,177,177,177,177,177,177,177,177,177,177,177,177,177,19,20,21,177,177,177,177,177,177,177,177,177,177
177,177,177,177,177,177,177,177,177,177,177,177,177,177,177,177,177,177,177,177,177,19,20,21,177,177,177,177,177,177,177,177,177,177,177,177,177,19,20,21,177,177,177,177,177,177,177,177,177,177
177,177,177,177,177,177,177,177,177,177,177,177,177,177,177,177,177,177,177,177,177,19,20,21,177,177,177,177,177,177,177,177,177,177,177,177,177,19,20,21,177,177,177,177,177,177,177,177,177,177
177,177,177,177,177,177,177,177,177,177,177,177,177,177,177,177,177,177,177,177,177,19,20,21,177,177,177,177,177,177,177,177,177,177,177,177,177,19,20,21,177,177,177,177,177,177,177,177,177,177
177,177,177,177,177,177,177,177,177,177,177,177,177,177,177,177,177,177,177,177,177,19,20,21,177,177,177,177,177,177,177,177,177,177,177,177,177,19,20,21,177,177,177,177,177,177,177,177,177,177
177,177,177,177,177,177,177,177,177,177,177,177,177,177,177,177,177,177,177,177,177,19,20,21,177,177,177,177,177,177,177,177,177,177,177,177,177,19,20,21,177,177,177,177,177,177,177,177,177,177
177,177,177,177,177,177,177,177,177,177,177,177,177,177,177,177,177,177,177,177,177,19,20,21,177,177,177,177,177,177,177,177,177,177,177,177,177,19,20,21,177,177,177,177,177,177,177,177,177,177
177,177,177,177,177,177,177,177,177,177,177,177,177,177,177,177,177,177,177,177,177,19,20,21,177,177,177,177,177,177,177,177,177,177,177,177,177,19,20,21,177,177,177,177,177,177,177,177,177,177
177,177,177,177,177,177,177,177,177,177,177,177,177,177,177,177,177,177,177,177,177,19,20,21,177,177,177,177,177,177,177,177,177,177,177,177,177,19,20,21,177,177,177,177,177,177,177,177,177,177
177,177,177,177,177,177,177,177,177,177,177,177,177,177,177,177,177,177,177,177,177,19,20,21,177,177,177,177,177,177,177,177,177,177,177,177,177,19,20,21,177,177,177,177,177,177,177,177,177,177
177,177,177,177,177,177,177,177,177,177,177,177,177,177,177,177,177,177,177,177,177,19,20,21,177,177,177,177,177,177,177,177,177,177,177,177,177,19,20,21,177,177,177,177,177,177,177,177,177,177
1,1,1,1,1,1,1,1,1,1,1,1,1,1,1,1,1,1,1,1,2,19,20,67,4,4,4,4,4,4,4,4,4,4,4,4,4,68,20,67,4,4,4,4,4,4,4,4,4,4
17,17,17,17,17,17,17,17,17,17,17,17,17,17,17,17,17,17,17,17,18,19,20,20,20,20,20,20,20,20,20,20,20,20,20,20,20,20,20,20,20,20,20,20,20,20,20,20,20,20
33,33,33,33,33,33,33,33,33,33,33,33,33,33,33,33,33,33,33,33,34,35,36,36,36,36,36,36,52,20,51,36,52,20,51,36,36,36,36,36,36,36,36,36,36,36,36,36,36,36
193,193,193,193,193,193,193,193,193,193,193,193,193,193,193,193,193,193,193,193,193,193,193,193,193,193,193,193,35,36,37,193,35,36,37,193,193,193,193,193,193,193,193,193,193,193,193,193,193,193
209,209,209,209,209,209,209,209,209,209,209,209,209,209,209,209,209,209,209,209,209,209,209,209,209,209,209,209,209,209,209,209,209,209,209,209,209,209,209,209,209,209,209,209,209,209,209,209,209,209
163,163,163,163,163,163,163,163,163,163,163,163,163,163,163,163,163,163,163,163,163,163,163,163,163,163,163,163,163,163,163,163,163,163,163,163,163,163,163,163,163,163,163,163,163,163,163,163,163,163
163,163,163,163,163,163,163,163,163,163,163,163,163,163,163,163,163,163,163,163,163,163,163,163,163,163,163,163,163,163,163,163,163,163,163,163,163,163,163,163,163,163,163,163,163,163,163,163,163,163
163,163,163,163,163,163,163,163,163,163,163,163,163,163,163,163,163,163,163,163,163,163,163,163,163,163,163,163,163,163,163,163,163,163,163,163,163,163,163,163,163,163,163,163,163,163,163,163,163,163
163,163,163,163,163,163,163,163,163,163,163,163,163,163,163,163,163,163,163,163,163,163,163,163,163,163,163,163,163,163,163,163,163,163,163,163,163,163,163,163,163,163,163,163,163,163,163,163,163,163
163,163,163,163,163,163,163,163,163,163,163,163,163,163,163,163,163,163,163,163,163,163,163,163,163,163,163,163,163,163,163,163,163,163,163,163,163,163,163,163,163,163,163,163,163,163,163,163,163,163
163,163,163,163,163,163,163,163,163,163,163,163,163,163,163,163,163,163,163,163,163,163,163,163,163,163,163,163,163,163,163,163,163,163,163,163,163,163,163,163,163,163,163,163,163,163,163,163,163,163
163,163,163,163,163,163,163,163,163,163,163,163,163,163,163,163,163,163,163,163,163,163,163,163,163,163,163,163,163,163,163,163,163,163,163,163,163,163,163,163,163,163,163,163,163,163,163,163,163,163
163,163,163,163,163,163,163,163,163,163,163,163,163,163,163,163,163,163,163,163,163,163,163,163,163,163,163,163,163,163,163,163,163,163,163,163,163,163,163,163,163,163,163,163,163,163,163,163,163,163
163,163,163,163,160,161,161,161,161,162,163,163,163,163,163,163,163,163,163,163,163,163,163,163,163,163,163,163,163,163,163,163,163,163,163,163,163,163,163,163,163,163,163,163,163,163,163,163,163,163
163,163,163,160,177,177,177,177,177,177,162,163,163,163,163,163,163,163,163,163,163,163,163,163,163,163,163,163,163,163,163,163,163,163,163,163,163,163,163,163,163,163,163,163,163,163,163,163,163,163
163,163,160,177,177,177,177,177,177,177,177,161,161,162,163,163,163,163,163,163,163,163,163,163,163,163,163,163,163,163,163,163,163,163,163,163,163,163,163,163,163,163,163,163,163,163,163,163,163,163
163,163,176,177,177,177,177,177,177,177,177,177,177,178,163,163,163,163,163,163,163,163,163,163,163,163,163,163,163,163,163,163,163,163,163,163,163,163,163,163,163,163,163,163,163,163,163,163,163,163
163,163,192,193,193,193,193,193,193,193,193,193,193,194,163,163,163,163,163,163,163,163,163,163,163,163,163,163,163,163,163,163,163,163,163,163,163,163,163,163,163,163,163,163,163,163,163,163,163,163
163,163,208,209,209,209,209,209,209,209,209,209,209,210,163,163,163,163,163,163,163,163,163,163,163,163,163,163,163,163,163,163,163,163,163,163,163,163,163,163,163,163,163,163,163,163,163,163,163,163
